1111111111
1C000000C1
10000000P1
1100E00001
1000000001
1000000001
10C0000001
1000000001
1C000000C1
1111111111